****************
****************
****************
***./___________
_x_/__I_^_______
################