





    /___________
_X_/__I_^_______
################






    /___________
_X_/__I_^_______
################