0000000000000000000000000000000000000000
0                                      0
0                                      0
0                                      0
0                                      0
0                         _            0
0    /___________                      0
0_X_/__I_^_______                      0
########################################